5 8
0 0
5 5
4 5 5 4 3 3 2 1
1 4 1 4 0 1 2 4
1 5 5 3 2 3 2 2
0 4 0 0 4 2 4 0
1 0 5 0 4 2 3 1
