5 8
0 0
5 5
2 0 5 5 2 3 5 0
5 0 4 0 1 1 1 2
1 5 2 5 4 2 3 3
4 3 2 0 3 5 0 1
4 3 4 2 5 5 0 5
