5 8
0 0
5 5
1 4 1 1 1 3 1 3
1 5 1 1 3 2 2 3
4 5 5 2 1 4 3 0
4 4 5 2 1 2 1 5
0 5 2 5 4 0 3 4
